siteName	waterBodyGroup2	waterBodyGroup3
二仁溪口南側	(B) 高屏溪口至曾文溪口間海域	(I) 二仁溪出海口附近
二仁溪口北側	(B) 高屏溪口至曾文溪口	(I) 二仁溪出海口附近
二仁溪口外側	(B) 高屏溪口至曾文溪口	(I) 二仁溪出海口附近
二仁溪口	(B) 高屏溪口至曾文溪口	(I) 二仁溪出海口附近
二仁溪口外4海浬	(B) 高屏溪口至曾文溪口	(I) 二仁溪出海口附近
台中港沿海一	(D) 王功漁港至鼻頭角	(M) 台中港附近
台中港沿海二	(D) 王功漁港至鼻頭角	(M) 台中港附近
頭前溪口南側	(D) 王功漁港至鼻頭角	(N) 竹苗沿海
鳳山溪北側	(D) 王功漁港至鼻頭角	(N) 竹苗沿海
客雅溪河口外4海浬處	(D) 王功漁港至鼻頭角	(N) 竹苗沿海
紅毛港外	(D) 王功漁港至鼻頭角	(N) 竹苗沿海
中港溪口一	(D) 王功漁港至鼻頭角	(N) 竹苗沿海
中港溪口二	(D) 王功漁港至鼻頭角	(N) 竹苗沿海
通霄溪口	(D) 王功漁港至鼻頭角	(N) 竹苗沿海
大安溪口	(D) 王功漁港至鼻頭角	(N) 竹苗沿海
核四預定地外海	(A) 鼻頭角至高屏溪口	(C) 宜蘭沿海
龜山島	(A) 鼻頭角至高屏溪口	(C) 宜蘭沿海
得子口溪口	(A) 鼻頭角至高屏溪口	(C) 宜蘭沿海
蘭陽溪口	(A) 鼻頭角至高屏溪口	(C) 宜蘭沿海
新城溪口	(A) 鼻頭角至高屏溪口	(C) 宜蘭沿海
蘇澳港	(A) 鼻頭角至高屏溪口	(C) 宜蘭沿海
東引北部沿海	(G) 東引海域	(R) 東引島
和平溪河口	(A) 鼻頭角至高屏溪口	(D) 花東沿海
和平溪口外4海浬處	(A) 鼻頭角至高屏溪口	(D) 花東沿海
和平港	(A) 鼻頭角至高屏溪口	(D) 花東沿海
立霧溪河口	(A) 鼻頭角至高屏溪口	(D) 花東沿海
花蓮港	(A) 鼻頭角至高屏溪口	(D) 花東沿海
花蓮溪河口	(A) 鼻頭角至高屏溪口	(D) 花東沿海
豐濱溪河口	(A) 鼻頭角至高屏溪口	(D) 花東沿海
秀姑巒溪河口	(A) 鼻頭角至高屏溪口	(D) 花東沿海
卑南溪河口	(A) 鼻頭角至高屏溪口	(D) 花東沿海
知本溪口	(A) 鼻頭角至高屏溪口	(D) 花東沿海
富岡港外	(A) 鼻頭角至高屏溪口	(D) 花東沿海
成功港外海	(A) 鼻頭角至高屏溪口	(D) 花東沿海
綠島	(A) 鼻頭角至高屏溪口	(D) 花東沿海
卑南溪口外4海浬	(A) 鼻頭角至高屏溪口	(D) 花東沿海
金門后江灣外	(E) 金門海域	(P) 金門
金烈水道南側	(E) 金門海域	(P) 金門
金門本島東側沿海	(E) 金門海域	(P) 金門
核三廠出水口右側	(A) 鼻頭角至高屏溪口	(F) 恆春半島南端
核三廠出水口左側	(A) 鼻頭角至高屏溪口	(F) 恆春半島南端
核三廠入水口	(A) 鼻頭角至高屏溪口	(F) 恆春半島南端
後壁湖漁港	(A) 鼻頭角至高屏溪口	(F) 恆春半島南端
南灣	(A) 鼻頭角至高屏溪口	(F) 恆春半島南端
石牛溪口	(A) 鼻頭角至高屏溪口	(F) 恆春半島南端
南竿鄉北部沿海	(F) 馬祖海域	(Q) 馬祖主島
馬祖海峽	(F) 馬祖海域	(Q) 馬祖主島
北竿東部沿海	(F) 馬祖海域	(Q) 馬祖主島
中芸港外	(B) 高屏溪口至曾文溪口	(G) 高屏溪出海口附近
高屏溪東港溪之間-1	(B) 高屏溪口至曾文溪口	(G) 高屏溪出海口附近
高屏溪口外4海浬	(A) 鼻頭角至高屏溪口	(G) 高屏溪出海口附近
高屏溪出海口	(A) 鼻頭角至高屏溪口	(G) 高屏溪出海口附近
東港溪出海口	(A) 鼻頭角至高屏溪口	(G) 高屏溪出海口附近
大鵬灣灣內-1	(A) 鼻頭角至高屏溪口	(G) 高屏溪出海口附近
大鵬灣灣內-2	(A) 鼻頭角至高屏溪口	(G) 高屏溪出海口附近
高雄港口外一	(B) 高屏溪口至曾文溪口	(H) 高雄港附近
高雄港口外二	(B) 高屏溪口至曾文溪口	(H) 高雄港附近
高雄港口外三	(B) 高屏溪口至曾文溪口	(H) 高雄港附近
旗津	(B) 高屏溪口至曾文溪口	(H) 高雄港附近
基隆港一	(D) 王功漁港至鼻頭角	(B) 基隆沿海
基隆港二	(D) 王功漁港至鼻頭角	(B) 基隆沿海
基隆拋泥區一	(D) 王功漁港至鼻頭角	(B) 基隆沿海
八斗子垃圾場	(D) 王功漁港至鼻頭角	(B) 基隆沿海
和平島	(D) 王功漁港至鼻頭角	(B) 基隆沿海
濂洞溪外海	(D) 王功漁港至鼻頭角	(B) 基隆沿海
員山子分洪道出海口	(D) 王功漁港至鼻頭角	(B) 基隆沿海
八里污水廠外海一	(D) 王功漁港至鼻頭角	(A) 新北西面與桃園沿海
八里污水廠外海二	(D) 王功漁港至鼻頭角	(A) 新北西面與桃園沿海
林口發電廠外海	(D) 王功漁港至鼻頭角	(A) 新北西面與桃園沿海
深澳發電廠外海	(D) 王功漁港至鼻頭角	(A) 新北西面與桃園沿海
淡水河口外4海浬處	(D) 王功漁港至鼻頭角	(A) 新北西面與桃園沿海
林口發電廠	(D) 王功漁港至鼻頭角	(A) 新北西面與桃園沿海
深澳發電廠	(D) 王功漁港至鼻頭角	(A) 新北西面與桃園沿海
海湖電廠	(D) 王功漁港至鼻頭角	(A) 新北西面與桃園沿海
新南崁溪口	(D) 王功漁港至鼻頭角	(A) 新北西面與桃園沿海
沙崙中油卸油設施一	(D) 王功漁港至鼻頭角	(A) 新北西面與桃園沿海
沙崙中油卸油設施二	(D) 王功漁港至鼻頭角	(A) 新北西面與桃園沿海
觀音溪口	(D) 王功漁港至鼻頭角	(A) 新北西面與桃園沿海
北港溪口一	(C) 曾文溪口至王功漁港	(J) 嘉義沿海
東石港外海一	(C) 曾文溪口至王功漁港	(J) 嘉義沿海
東石港外海二	(C) 曾文溪口至王功漁港	(J) 嘉義沿海
布袋港外海一	(C) 曾文溪口至王功漁港	(J) 嘉義沿海
布袋港外海二	(C) 曾文溪口至王功漁港	(J) 嘉義沿海
八掌溪口北側	(C) 曾文溪口至王功漁港	(J) 嘉義沿海
朴子溪口外4海浬	(C) 曾文溪口至王功漁港	(J) 嘉義沿海
大肚溪口	(D) 王功漁港至鼻頭角	(L) 彰濱
大肚溪口外4海浬	(D) 王功漁港至鼻頭角	(L) 彰濱
彰濱沿海一	(D) 王功漁港至鼻頭角	(L) 彰濱
彰濱沿海二	(D) 王功漁港至鼻頭角	(L) 彰濱
彰濱沿海三	(C) 曾文溪口至王功漁港	(L) 彰濱
烏崁海域	(C) 曾文溪口至王功漁港	(O) 澎湖
紗帽山海域	(C) 曾文溪口至王功漁港	(O) 澎湖
龍門海域	(C) 曾文溪口至王功漁港	(O) 澎湖
吉貝海域	(C) 曾文溪口至王功漁港	(O) 澎湖
七美海域	(C) 曾文溪口至王功漁港	(O) 澎湖
望安海域	(C) 曾文溪口至王功漁港	(O) 澎湖
外垵4海浬外	(C) 曾文溪口至王功漁港	(O) 澎湖
濁水溪口一	(C) 曾文溪口至王功漁港	(K) 濁水溪出海口附近
濁水溪口二	(C) 曾文溪口至王功漁港	(K) 濁水溪出海口附近
濁水溪口外4海浬	(C) 曾文溪口至王功漁港	(K) 濁水溪出海口附近
六輕沿海一	(C) 曾文溪口至王功漁港	(K) 濁水溪出海口附近
六輕沿海二	(C) 曾文溪口至王功漁港	(K) 濁水溪出海口附近
台西外海	(C) 曾文溪口至王功漁港	(K) 濁水溪出海口附近
三條崙外海	(C) 曾文溪口至王功漁港	(K) 濁水溪出海口附近
蘭嶼	(A) 鼻頭角至高屏溪口	(E) 蘭嶼
