墾丁國家公園	國家公園法
東沙環礁國家公園	國家公園法
澎湖南方四島國家公園	國家公園法
台江國家公園	國家公園法
東北角暨宜蘭海岸國家風景區	都市計畫法
東部海岸國家風景區	發展觀光條例
馬祖列島燕鷗保護區	野生動物保育法
澎湖縣貓嶼海鳥保護區	野生動物保育法
棉花嶼花瓶嶼野生動物保護區	野生動物保育法
澎湖玄武岩自然保留區	文化資產保存法
旭海觀音鼻自然保留區	文化資產保存法
宜蘭縣蘇澳漁業資源保育區	漁業法
宜蘭縣頭城漁業資源保育區	漁業法
基隆市水產動植物保育區	漁業法
基隆市望海巷潮境海灣資源保育區	漁業法
貢寮水產動植物繁殖保育區	漁業法
新北市萬里水產動植物繁殖保育區	漁業法
新北市瑞芳保育區	漁業法
苗栗縣灣瓦海瓜子繁殖保育區	漁業法
彰化縣伸港螻蛄蝦繁殖保育區	漁業法
彰化縣伸港螻蛄蝦繁殖保育區二	漁業法
彰化縣王功螻蛄蝦繁殖保育區	漁業法
屏東縣琉球漁業資源保育區	漁業法
屏東縣車城漁業資源保育區	漁業法
屏東縣國立海洋生物博物館資源培育區	漁業法
台東縣綠島漁業資源保育區	漁業法
台東縣小馬漁業資源保育區	漁業法
台東縣小港漁業資源保育區	漁業法
台東縣宜灣漁業資源保育區	漁業法
台東縣富山漁業資源保育區	漁業法
花蓮縣壽豐鄉鹽寮保育區	漁業法
花蓮縣壽豐鄉水璉保育區	漁業法
花蓮縣豐濱鄉高山保育區	漁業法
花蓮縣豐濱鄉小湖保育區	漁業法
花蓮縣豐濱鄉豐濱保育區	漁業法
花蓮縣豐濱鄉石梯坪保育區	漁業法
澎湖縣小門漁業資源保育區	漁業法
澎湖縣七美漁業資源保育區	漁業法
金門縣古寧頭西北海域鱟保育區	漁業法
相關漁具漁法及特定漁業禁漁區	漁業法
